10 10
0 0
.........X
X.........
..........
..........
..........
.........X
..........
.X........
..........
..........
   1    1    1    1    1    1    1    1    1    1
1000    1 1000 1000 1000 1000 1000 1000 1000    1
1000    1 1000 1000 1000 1000 1000 1000 1000    1
1000    1    1 1000 1000 1000 1000 1000 1000    1
1000 1000    1 1000 1000 1000 1000 1000 1000    1
1000    1    1 1000    1    1    1    1    1    1
1000 1000    1 1000 1000 1000 1000 1000 1000 1000
   1    1    1    1    1    1    1    1    1    1
1000 1000 1000 1000 1000 1000 1000 1000 1000    1
   1    1    1    1    1    1    1    1    1    1