10 10
0 0
x.........
..........
..........
..........
...x......
..........
..........
..........
........x.
..........
1 1 1 1 1 1 1 1 1 
1 10 10 10 10 10 10 10 1 
1 10 10 10 10 10 10 10 1 
1 10 10 10 10 10 10 10 1 
1 1 1 1 1 10 10 10 1
1 10 10 10 10 10 10 10 1
1 10 10 10 10 10 10 10 1
1 10 10 10 10 10 10 10 1
1 1 1 1 1 1 1 1 1
